"aa" = (/turf/open/space/basic,/area/space)
"ab" = (/turf/closed/wall,/area/shuttle/escape)
"ac" = (/obj/structure/grille,/obj/structure/window/reinforced/fulltile,/turf/open/floor/plating,/area/shuttle/escape)
"ad" = (/obj/structure/grille,/obj/structure/window/reinforced/fulltile,/obj/structure/cable{icon_state = "0-4"; d2 = 4},/turf/open/floor/plating,/area/shuttle/escape)
"ae" = (/obj/structure/grille,/obj/structure/window/reinforced/fulltile,/obj/structure/cable{d1 = 2; d2 = 8; icon_state = "2-8"},/obj/structure/cable{icon_state = "0-2"; pixel_y = 1; d2 = 2},/turf/open/floor/plating,/area/shuttle/escape)
"af" = (/obj/structure/grille,/obj/structure/window/reinforced/fulltile,/obj/structure/cable{icon_state = "0-2"; pixel_y = 1; d2 = 2},/turf/open/floor/plating,/area/shuttle/escape)
"ag" = (/obj/machinery/power/smes/magical{name = "Power storage unit"},/obj/structure/cable{icon_state = "0-4"; d2 = 4},/obj/effect/decal/cleanable/cobweb,/turf/open/floor/plasteel/yellow/side{dir = 8},/area/shuttle/escape)
"ah" = (/obj/structure/cable{d1 = 4; d2 = 8; icon_state = "4-8"; pixel_y = 0},/mob/living/simple_animal/bot/floorbot,/turf/open/floor/plasteel,/area/shuttle/escape)
"ai" = (/obj/machinery/suit_storage_unit/mining/eva,/obj/structure/cable{d1 = 2; d2 = 8; icon_state = "2-8"},/turf/open/floor/plasteel/yellow/side{dir = 4},/area/shuttle/escape)
"aj" = (/obj/structure/table,/obj/item/weapon/paper_bin,/obj/item/weapon/pen,/turf/open/floor/plasteel/blue/side{dir = 1},/area/shuttle/escape)
"ak" = (/obj/machinery/computer/emergency_shuttle,/turf/open/floor/plasteel/blue/side{dir = 1},/area/shuttle/escape)
"al" = (/obj/machinery/computer/crew,/obj/structure/cable{d1 = 1; d2 = 4; icon_state = "1-4"},/turf/open/floor/plasteel/blue/side{dir = 1},/area/shuttle/escape)
"am" = (/obj/machinery/computer/communications,/obj/machinery/camera,/obj/structure/cable{d1 = 4; d2 = 8; icon_state = "4-8"; pixel_y = 0},/obj/structure/cable{d1 = 1; d2 = 4; icon_state = "1-4"},/turf/open/floor/plasteel/blue/side{dir = 1},/area/shuttle/escape)
"an" = (/obj/structure/cable{d1 = 2; d2 = 8; icon_state = "2-8"},/obj/structure/closet/emcloset,/turf/open/floor/plasteel/blue/side{dir = 1},/area/shuttle/escape)
"ao" = (/obj/machinery/vending/engivend,/obj/machinery/camera{dir = 4},/turf/open/floor/plasteel/yellow/side{dir = 8},/area/shuttle/escape)
"ap" = (/turf/open/floor/plasteel,/area/shuttle/escape)
"aq" = (/obj/machinery/suit_storage_unit/mining/eva,/obj/structure/cable{icon_state = "1-2"},/turf/open/floor/plasteel/yellow/side{dir = 4},/area/shuttle/escape)
"ar" = (/obj/machinery/r_n_d/circuit_imprinter,/obj/effect/turf_decal/delivery,/turf/open/floor/plasteel/whiteyellow/side{dir = 9},/area/shuttle/escape)
"as" = (/turf/open/floor/plasteel/whiteyellow/side{dir = 1},/area/shuttle/escape)
"at" = (/obj/machinery/light{dir = 1},/obj/machinery/r_n_d/protolathe,/obj/effect/turf_decal/delivery,/turf/open/floor/plasteel/whiteyellow/side{dir = 1},/area/shuttle/escape)
"au" = (/obj/machinery/autolathe,/obj/effect/turf_decal/delivery,/obj/effect/decal/cleanable/cobweb/cobweb2,/turf/open/floor/plasteel/whiteyellow/side{dir = 5},/area/shuttle/escape)
"av" = (/obj/structure/table,/obj/item/weapon/folder/yellow,/turf/open/floor/plasteel,/area/shuttle/escape)
"aw" = (/obj/structure/chair/office/light{dir = 1},/turf/open/floor/plasteel,/area/shuttle/escape)
"ax" = (/obj/structure/extinguisher_cabinet{pixel_x = 28},/obj/structure/cable{d1 = 1; d2 = 2; icon_state = "1-2"},/turf/open/floor/plasteel,/area/shuttle/escape)
"ay" = (/obj/machinery/light{icon_state = "tube1"; dir = 8},/obj/machinery/vending/tool,/obj/structure/cable{icon_state = "1-2"},/turf/open/floor/plasteel/yellow/side{dir = 8},/area/shuttle/escape)
"az" = (/obj/structure/closet/crate/rcd,/obj/structure/cable{icon_state = "1-2"},/obj/structure/window/reinforced,/turf/open/floor/plasteel/yellow/side{dir = 4},/area/shuttle/escape)
"aA" = (/obj/machinery/r_n_d/destructive_analyzer,/obj/machinery/camera{dir = 4},/obj/effect/turf_decal/delivery,/turf/open/floor/plasteel/whiteyellow/side{dir = 8},/area/shuttle/escape)
"aB" = (/turf/open/floor/plasteel/white,/area/shuttle/escape)
"aC" = (/obj/machinery/computer/rdconsole/core,/obj/effect/turf_decal/delivery,/turf/open/floor/plasteel/white,/area/shuttle/escape)
"aD" = (/obj/structure/noticeboard/rd{pixel_x = 32},/obj/structure/table,/obj/item/stack/sheet/metal{amount = 50},/obj/item/stack/sheet/glass{amount = 50},/turf/open/floor/plasteel/whiteyellow/side{dir = 4},/area/shuttle/escape)
"aE" = (/obj/machinery/computer/camera_advanced,/turf/open/floor/plasteel,/area/shuttle/escape)
"aF" = (/obj/structure/chair/office/light{dir = 8},/turf/open/floor/plasteel,/area/shuttle/escape)
"aG" = (/obj/machinery/button/flasher{id = "shuttleflash"; pixel_y = -24},/turf/open/floor/plasteel/blue/side,/area/shuttle/escape)
"aH" = (/obj/structure/cable{d1 = 1; d2 = 2; icon_state = "1-2"},/turf/open/floor/plasteel/blue/side,/area/shuttle/escape)
"aI" = (/obj/structure/table,/obj/item/stack/sheet/metal{amount = 50},/obj/item/stack/sheet/glass{amount = 50},/obj/item/stack/cable_coil,/obj/item/clothing/gloves/color/yellow,/turf/open/floor/plasteel/yellow/side{dir = 8},/area/shuttle/escape)
"aJ" = (/obj/structure/cable{icon_state = "1-2"},/turf/open/floor/plasteel/yellow/side{dir = 4},/area/shuttle/escape)
"aK" = (/obj/structure/disposalpipe/segment{dir = 4; icon_state = "pipe-c"},/turf/closed/wall,/area/shuttle/escape)
"aL" = (/obj/structure/disposalpipe/segment{dir = 4},/turf/open/floor/plasteel/whiteyellow/side{dir = 10},/area/shuttle/escape)
"aM" = (/obj/structure/disposalpipe/segment{dir = 4},/obj/structure/extinguisher_cabinet{pixel_y = -32},/turf/open/floor/plasteel/whiteyellow/side,/area/shuttle/escape)
"aN" = (/obj/structure/disposalpipe/segment{dir = 4},/turf/open/floor/plasteel/whiteyellow/side,/area/shuttle/escape)
"aO" = (/obj/structure/disposalpipe/trunk{dir = 8},/obj/machinery/disposal/bin,/turf/open/floor/plasteel/whiteyellow/side{dir = 6},/area/shuttle/escape)
"aP" = (/obj/structure/displaycase/captain,/obj/structure/window/reinforced{dir = 1; pixel_y = 1},/turf/open/floor/plasteel/blue/side,/area/shuttle/escape)
"aQ" = (/obj/machinery/light,/obj/structure/fireaxecabinet{pixel_y = -30},/turf/open/floor/plasteel/blue/side,/area/shuttle/escape)
"aR" = (/obj/structure/disposalpipe/trunk{dir = 4},/obj/machinery/disposal/bin,/turf/open/floor/plasteel/blue/side,/area/shuttle/escape)
"aS" = (/obj/structure/disposalpipe/segment{dir = 4},/turf/closed/wall,/area/shuttle/escape)
"aT" = (/obj/structure/disposalpipe/segment{dir = 4},/obj/machinery/door/airlock/glass_command{name = "Cockpit"; req_access_txt = "19"},/obj/structure/cable{d1 = 1; d2 = 2; icon_state = "1-2"},/turf/open/floor/plasteel,/area/shuttle/escape)
"aU" = (/obj/structure/disposalpipe/segment{dir = 4},/obj/machinery/door/airlock/engineering{name = "Engineering"},/obj/structure/cable{icon_state = "1-2"},/turf/open/floor/plasteel,/area/shuttle/escape)
"aV" = (/obj/structure/disposalpipe/junction,/turf/closed/wall,/area/shuttle/escape)
"aW" = (/obj/machinery/door/airlock/glass_science{name = "Research"},/turf/open/floor/plasteel/whiteyellow/side{dir = 1},/area/shuttle/escape)
"aX" = (/obj/structure/cable{d1 = 1; d2 = 2; icon_state = "1-2"},/obj/machinery/light/small{dir = 4},/turf/open/floor/plasteel,/area/shuttle/escape)
"aY" = (/obj/machinery/vending/cola,/obj/effect/decal/cleanable/cobweb,/turf/open/floor/plasteel/yellow/side{dir = 1; icon_state = "yellow"; initial_gas_mix = "o2=22;n2=82;TEMP=293.15"},/area/shuttle/escape)
"aZ" = (/obj/machinery/status_display{pixel_y = 32},/obj/machinery/vending/coffee,/turf/open/floor/plasteel/yellow/side{dir = 1; icon_state = "yellow"; initial_gas_mix = "o2=22;n2=82;TEMP=293.15"},/area/shuttle/escape)
"ba" = (/obj/structure/cable{icon_state = "1-2"},/obj/machinery/light/small{dir = 4},/turf/open/floor/plasteel/yellow/side{dir = 1; icon_state = "yellow"; initial_gas_mix = "o2=22;n2=82;TEMP=293.15"},/area/shuttle/escape)
"bb" = (/obj/structure/disposalpipe/segment,/turf/closed/wall,/area/shuttle/escape)
"bc" = (/obj/machinery/light/small{dir = 4},/turf/open/floor/plasteel,/area/shuttle/escape)
"bd" = (/obj/machinery/sleeper,/obj/machinery/camera{dir = 4},/obj/effect/turf_decal/bot,/turf/open/floor/plasteel/whiteblue/side{dir = 9},/area/shuttle/escape)
"be" = (/obj/machinery/sleeper,/obj/effect/turf_decal/bot,/turf/open/floor/plasteel/whiteblue/side{dir = 1},/area/shuttle/escape)
"bf" = (/obj/structure/table,/obj/item/weapon/storage/firstaid/brute,/obj/item/weapon/storage/firstaid/fire,/obj/item/weapon/storage/firstaid/regular,/obj/item/weapon/storage/firstaid/toxin,/turf/open/floor/plasteel/whiteblue/side{dir = 5},/area/shuttle/escape)
"bg" = (/obj/item/weapon/bedsheet/red,/obj/structure/bed,/turf/open/floor/plasteel/red/side{dir = 9},/area/shuttle/escape)
"bh" = (/obj/machinery/camera,/obj/effect/decal/cleanable/dirt,/turf/open/floor/plasteel/red/side{dir = 1},/area/shuttle/escape)
"bi" = (/obj/structure/chair/office{dir = 8},/turf/open/floor/plasteel/red/side{dir = 5},/area/shuttle/escape)
"bj" = (/obj/structure/grille,/obj/structure/window/reinforced/fulltile,/obj/structure/cable{d1 = 2; d2 = 4; icon_state = "2-4"},/obj/structure/cable{icon_state = "0-4"; d2 = 4},/turf/open/floor/plating,/area/shuttle/escape)
"bk" = (/obj/structure/cable{d1 = 4; d2 = 8; icon_state = "4-8"; pixel_y = 0},/obj/structure/cable{d1 = 1; d2 = 4; icon_state = "1-4"},/turf/open/floor/plasteel,/area/shuttle/escape)
"bl" = (/obj/machinery/camera{c_tag = "Courtroom - Fore"; dir = 2; name = "security camera"},/obj/structure/cable{d1 = 4; d2 = 8; icon_state = "4-8"; pixel_y = 0},/obj/machinery/flasher{id = "shuttleflash"; pixel_y = 24},/turf/open/floor/plasteel,/area/shuttle/escape)
"bm" = (/obj/structure/cable{d1 = 4; d2 = 8; icon_state = "4-8"; pixel_y = 0},/obj/structure/cable{d1 = 2; d2 = 4; icon_state = "2-4"},/turf/open/floor/plasteel,/area/shuttle/escape)
"bn" = (/obj/structure/cable{d1 = 4; d2 = 8; icon_state = "4-8"; pixel_y = 0},/turf/open/floor/plasteel,/area/shuttle/escape)
"bo" = (/obj/structure/cable{icon_state = "1-8"},/turf/open/floor/plasteel,/area/shuttle/escape)
"bp" = (/obj/machinery/door/airlock/glass_medical{name = "Medbay"},/turf/open/floor/plasteel/cmo,/area/shuttle/escape)
"bq" = (/obj/machinery/vending/wallmed{pixel_x = -30; pixel_y = 32},/turf/open/floor/plasteel/whiteblue/side{dir = 10},/area/shuttle/escape)
"br" = (/mob/living/simple_animal/bot/medbot{name = "\improper emergency medibot"; pixel_x = -3; pixel_y = 2},/turf/open/floor/plasteel/whiteblue/side,/area/shuttle/escape)
"bs" = (/obj/structure/bed/roller,/obj/machinery/light/small{dir = 4},/turf/open/floor/plasteel/whiteblue/side{dir = 6},/area/shuttle/escape)
"bt" = (/obj/machinery/light{icon_state = "tube1"; dir = 8},/obj/structure/chair/office{dir = 4},/turf/open/floor/plasteel,/area/shuttle/escape)
"bu" = (/obj/structure/chair/office{dir = 8},/obj/effect/decal/cleanable/dirt,/turf/open/floor/plasteel/floorgrime,/area/shuttle/escape)
"bv" = (/obj/structure/grille,/obj/structure/window/reinforced/fulltile,/obj/structure/cable,/turf/open/floor/plating,/area/shuttle/escape)
"bw" = (/obj/structure/cable{icon_state = "1-2"},/obj/structure/window/reinforced{dir = 1; pixel_y = 1},/obj/structure/chair/office,/turf/open/floor/plasteel,/area/shuttle/escape)
"bx" = (/obj/structure/window/reinforced{dir = 1; pixel_y = 1},/obj/structure/chair/office,/turf/open/floor/plasteel,/area/shuttle/escape)
"by" = (/obj/structure/sign/poster/ripped{pixel_x = -32},/turf/open/floor/plasteel,/area/shuttle/escape)
"bz" = (/obj/structure/sign/bluecross_2,/turf/closed/wall,/area/shuttle/escape)
"bA" = (/obj/structure/chair/office{dir = 4},/turf/open/floor/plasteel/red/side{dir = 10},/area/shuttle/escape)
"bB" = (/turf/open/floor/plasteel/red/side,/area/shuttle/escape)
"bC" = (/obj/structure/chair/office{dir = 8},/turf/open/floor/plasteel/red/side{dir = 6},/area/shuttle/escape)
"bD" = (/obj/structure/extinguisher_cabinet{pixel_x = -28},/turf/open/floor/plasteel,/area/shuttle/escape)
"bE" = (/obj/structure/cable{icon_state = "1-2"},/obj/structure/table,/turf/open/floor/plasteel,/area/shuttle/escape)
"bF" = (/obj/structure/table,/turf/open/floor/plasteel,/area/shuttle/escape)
"bG" = (/obj/structure/disposalpipe/junction{icon_state = "pipe-j2"; dir = 2},/turf/closed/wall,/area/shuttle/escape)
"bH" = (/obj/structure/disposalpipe/segment{dir = 4},/turf/open/floor/plasteel,/area/shuttle/escape)
"bI" = (/obj/structure/disposalpipe/trunk{dir = 8},/obj/machinery/disposal/bin,/obj/machinery/camera{c_tag = "Security - Prison"; dir = 2; name = "security camera"},/turf/open/floor/plasteel,/area/shuttle/escape)
"bJ" = (/obj/machinery/vending/cigarette,/obj/structure/window/reinforced{dir = 8},/turf/open/floor/plasteel,/area/shuttle/escape)
"bK" = (/obj/machinery/vending/snack,/turf/open/floor/plasteel,/area/shuttle/escape)
"bL" = (/obj/machinery/vending/sovietsoda,/turf/open/floor/plasteel,/area/shuttle/escape)
"bM" = (/obj/machinery/door/window/brigdoor{dir = 1; name = "Shuttle Cell"},/turf/open/floor/plasteel,/area/shuttle/escape)
"bN" = (/obj/machinery/light{icon_state = "tube1"; dir = 8},/obj/structure/sign/poster/official/nanotrasen_logo{pixel_x = -32},/turf/open/floor/plasteel,/area/shuttle/escape)
"bO" = (/obj/structure/cable{icon_state = "1-2"},/obj/structure/window/reinforced,/obj/structure/chair/office{dir = 1},/turf/open/floor/plasteel,/area/shuttle/escape)
"bP" = (/obj/structure/window/reinforced,/obj/structure/chair/office{dir = 1},/turf/open/floor/plasteel,/area/shuttle/escape)
"bQ" = (/obj/machinery/light{dir = 4},/obj/structure/window/reinforced,/obj/structure/chair/office{dir = 1},/turf/open/floor/plasteel,/area/shuttle/escape)
"bR" = (/obj/machinery/light{icon_state = "tube1"; dir = 8},/turf/open/floor/plasteel,/area/shuttle/escape)
"bS" = (/turf/closed/wall/r_wall,/area/shuttle/escape)
"bT" = (/obj/structure/reagent_dispensers/peppertank{pixel_y = 30},/obj/structure/chair/office{dir = 4},/mob/living/simple_animal/bot/secbot/beepsky{desc = "It's Officer Beepsky! Powered by a potato and a shot of whiskey."; name = "Officer Beepsky"},/turf/open/floor/plasteel/red/corner{dir = 1},/area/shuttle/escape)
"bU" = (/obj/structure/table,/obj/machinery/recharger{pixel_y = 6},/obj/item/weapon/restraints/handcuffs,/obj/item/weapon/restraints/handcuffs,/obj/item/weapon/restraints/handcuffs,/turf/open/floor/plasteel/red/corner{dir = 4},/area/shuttle/escape)
"bV" = (/obj/machinery/door/unpowered/shuttle,/turf/open/floor/plasteel,/area/shuttle/escape)
"bW" = (/obj/machinery/light/small,/turf/open/floor/plasteel,/area/shuttle/escape)
"bX" = (/obj/machinery/door/airlock/glass_security,/turf/open/floor/plasteel,/area/shuttle/escape)
"bY" = (/obj/structure/cable{icon_state = "1-2"},/turf/open/floor/plasteel/goonplaque,/area/shuttle/escape)
"bZ" = (/obj/structure/disposalpipe/segment,/obj/structure/closet/emcloset,/turf/open/floor/plasteel,/area/shuttle/escape)
"ca" = (/obj/structure/chair/office{dir = 8},/obj/structure/window/reinforced{dir = 4},/turf/open/floor/plasteel,/area/shuttle/escape)
"cb" = (/obj/structure/chair/office{dir = 4},/obj/structure/window/reinforced{dir = 8},/turf/open/floor/plasteel,/area/shuttle/escape)
"cc" = (/obj/structure/extinguisher_cabinet{pixel_x = 28},/obj/structure/chair/office{dir = 8},/turf/open/floor/plasteel,/area/shuttle/escape)
"cd" = (/obj/machinery/holopad,/obj/structure/cable{icon_state = "1-2"},/turf/open/floor/plasteel,/area/shuttle/escape)
"ce" = (/obj/structure/disposalpipe/segment,/turf/open/floor/plasteel,/area/shuttle/escape)
"cf" = (/obj/structure/chair/office{dir = 8},/turf/open/floor/plasteel,/area/shuttle/escape)
"cg" = (/obj/docking_port/mobile/emergency{dwidth = 14; height = 18; name = "Centcomm Raven Battlecruiser"; timid = 1; width = 32},/obj/machinery/door/unpowered/shuttle,/turf/open/floor/plasteel,/area/shuttle/escape)
"ch" = (/obj/structure/cable{d1 = 1; d2 = 4; icon_state = "1-4"},/turf/open/floor/plasteel,/area/shuttle/escape)
"ci" = (/obj/structure/cable{d1 = 4; d2 = 8; icon_state = "4-8"; pixel_y = 0},/turf/open/floor/plasteel/brownold,/area/shuttle/escape)
"cj" = (/obj/structure/cable{d1 = 4; d2 = 8; icon_state = "4-8"; pixel_y = 0},/turf/open/floor/plasteel/green/side,/area/shuttle/escape)
"ck" = (/obj/structure/cable{icon_state = "1-8"},/turf/open/floor/plasteel/brownold,/area/shuttle/escape)
"cl" = (/turf/open/floor/plasteel/green/side,/area/shuttle/escape)
"cm" = (/turf/open/floor/plasteel/brownold,/area/shuttle/escape)
"cn" = (/obj/structure/chair/office{dir = 8},/obj/structure/sign/poster/random{pixel_x = 32},/turf/open/floor/plasteel,/area/shuttle/escape)
"co" = (/obj/machinery/camera{c_tag = "Security - Brig Center"; dir = 4; name = "security camera"},/obj/structure/chair/office{dir = 4},/turf/open/floor/plasteel,/area/shuttle/escape)
"cp" = (/obj/structure/chair/office{dir = 8},/obj/machinery/light{dir = 4},/turf/open/floor/plasteel,/area/shuttle/escape)
"cq" = (/obj/structure/window/reinforced/fulltile,/turf/open/floor/grass,/area/shuttle/escape)
"cr" = (/obj/structure/disposalpipe/segment,/obj/machinery/light{icon_state = "tube1"; dir = 8},/turf/open/floor/plasteel,/area/shuttle/escape)
"cs" = (/obj/machinery/camera{c_tag = "Lawyer's Office"; dir = 8; name = "security camera"},/obj/structure/chair/office{dir = 8},/obj/machinery/light{dir = 4},/turf/open/floor/plasteel,/area/shuttle/escape)
"ct" = (/obj/structure/chair/office{dir = 4},/turf/open/floor/plasteel,/area/shuttle/escape)
"cu" = (/mob/living/simple_animal/chick,/turf/open/floor/grass,/area/shuttle/escape)
"cv" = (/mob/living/simple_animal/chicken,/turf/open/floor/grass,/area/shuttle/escape)
"cw" = (/mob/living/simple_animal/pet/fox/Renault,/turf/open/floor/grass,/area/shuttle/escape)
"cx" = (/turf/open/floor/grass,/area/shuttle/escape)
"cy" = (/obj/structure/flora/tree/palm,/turf/open/floor/grass,/area/shuttle/escape)
"cz" = (/obj/machinery/door/airlock/glass,/turf/open/floor/grass,/area/shuttle/escape)
"cA" = (/obj/machinery/hydroponics/soil,/mob/living/simple_animal/cow,/turf/open/floor/grass,/area/shuttle/escape)
"cB" = (/obj/item/toy/beach_ball,/turf/open/floor/grass,/area/shuttle/escape)
"cC" = (/obj/machinery/hydroponics/soil,/mob/living/simple_animal/pet/cat/space,/turf/open/floor/grass,/area/shuttle/escape)
"cD" = (/obj/structure/extinguisher_cabinet{pixel_y = -32},/obj/structure/chair/office{dir = 4},/obj/structure/window/reinforced{dir = 8},/turf/open/floor/plasteel,/area/shuttle/escape)
"cE" = (/obj/structure/extinguisher_cabinet{pixel_x = -28},/obj/structure/chair/office{dir = 4},/turf/open/floor/plasteel,/area/shuttle/escape)
"cF" = (/obj/machinery/light{dir = 4},/turf/open/floor/plasteel,/area/shuttle/escape)
"cG" = (/obj/item/weapon/twohanded/required/kirbyplants/random,/obj/machinery/light{dir = 1},/turf/open/floor/plasteel/brownold{dir = 1},/area/shuttle/escape)
"cH" = (/obj/structure/chair/comfy,/turf/open/floor/plasteel/green/side{dir = 1},/area/shuttle/escape)
"cI" = (/turf/open/floor/plasteel/brownold{dir = 1},/area/shuttle/escape)
"cJ" = (/obj/item/weapon/twohanded/required/kirbyplants/random,/turf/open/floor/plasteel/brownold{dir = 1},/area/shuttle/escape)
"cK" = (/obj/machinery/newscaster{pixel_x = 30; pixel_y = 2},/turf/open/floor/plasteel,/area/shuttle/escape)
"cL" = (/obj/item/weapon/bucket_sensor,/obj/item/weapon/tank/internals/oxygen/yellow,/obj/effect/decal/cleanable/oil,/turf/open/floor/plasteel/floorgrime,/area/shuttle/escape)
"cM" = (/obj/machinery/recharge_station,/obj/effect/decal/cleanable/cobweb/cobweb2,/obj/effect/decal/cleanable/dirt,/turf/open/floor/plasteel/bot,/area/shuttle/escape)
"cN" = (/obj/structure/closet/emcloset,/turf/open/floor/plasteel,/area/shuttle/escape)
"cO" = (/obj/machinery/camera{c_tag = "Security - Departures Starboard"; dir = 1; name = "security camera"},/turf/open/floor/plasteel,/area/shuttle/escape)
"cP" = (/obj/machinery/door/airlock/maintenance{name = "Storage"},/turf/open/floor/plasteel,/area/shuttle/escape)
"cQ" = (/obj/machinery/autolathe,/obj/structure/sign/nosmoking_2{pixel_x = 32},/turf/open/floor/plasteel/bot,/area/shuttle/escape)
"cR" = (/obj/structure/disposalpipe/trunk{dir = 4},/obj/machinery/disposal/bin,/turf/open/floor/plasteel,/area/shuttle/escape)
"cS" = (/obj/structure/disposalpipe/junction,/obj/machinery/door/airlock/maintenance{name = "Toilets"},/turf/open/floor/plasteel/airless,/area/shuttle/escape)
"cT" = (/obj/effect/decal/cleanable/dirt,/turf/open/floor/plasteel,/area/shuttle/escape)
"cU" = (/obj/machinery/light{dir = 4},/obj/structure/closet/crate/internals,/turf/open/floor/plasteel/bot,/area/shuttle/escape)
"cV" = (/obj/structure/grille,/obj/structure/window/fulltile,/turf/open/floor/plating,/area/shuttle/escape)
"cW" = (/obj/machinery/door/airlock/glass{name = "Bar"},/turf/open/floor/plasteel,/area/shuttle/escape)
"cX" = (/obj/structure/disposalpipe/segment,/turf/open/floor/plasteel/floorgrime,/area/shuttle/escape)
"cY" = (/obj/structure/window/reinforced/tinted{dir = 8},/obj/item/weapon/broken_bottle,/turf/open/floor/plasteel/floorgrime,/area/shuttle/escape)
"cZ" = (/obj/machinery/shower{dir = 8; icon_state = "shower"; name = "emergency shower"},/obj/structure/curtain,/obj/effect/decal/cleanable/cobweb/cobweb2,/turf/open/floor/plasteel/floorgrime,/area/shuttle/escape)
"da" = (/obj/structure/extinguisher_cabinet{pixel_x = -28},/obj/effect/decal/cleanable/deadcockroach,/mob/living/simple_animal/mouse,/turf/open/floor/plasteel/floorgrime,/area/shuttle/escape)
"db" = (/obj/structure/reagent_dispensers/fueltank,/obj/structure/sign/fire{pixel_x = 32},/turf/open/floor/plasteel/bot,/area/shuttle/escape)
"dc" = (/turf/open/floor/wood,/area/shuttle/escape)
"dd" = (/obj/machinery/vending/dinnerware,/turf/open/floor/wood,/area/shuttle/escape)
"de" = (/obj/structure/disposalpipe/segment,/obj/structure/sign/poster/contraband/communist_state{pixel_x = -32},/obj/effect/decal/cleanable/dirt,/turf/open/floor/plasteel/airless,/area/shuttle/escape)
"df" = (/obj/machinery/door/window/westleft,/obj/structure/window/reinforced/tinted,/turf/open/floor/plasteel,/area/shuttle/escape)
"dg" = (/obj/machinery/shower{dir = 8; icon_state = "shower"; name = "emergency shower"},/obj/structure/curtain,/obj/machinery/light/small{dir = 4},/obj/structure/window/reinforced/tinted,/turf/open/floor/plasteel,/area/shuttle/escape)
"dh" = (/obj/item/device/lightreplacer,/obj/effect/decal/cleanable/dirt,/obj/item/weapon/storage/toolbox/mechanical,/turf/open/floor/plasteel,/area/shuttle/escape)
"di" = (/obj/structure/reagent_dispensers/watertank,/obj/effect/decal/cleanable/greenglow,/turf/open/floor/plasteel/bot,/area/shuttle/escape)
"dj" = (/obj/structure/chair/stool/bar,/turf/open/floor/wood,/area/shuttle/escape)
"dk" = (/obj/structure/piano{icon_state = "piano"},/obj/machinery/light,/turf/open/floor/wood,/area/shuttle/escape)
"dl" = (/obj/structure/chair/comfy{dir = 8},/turf/open/floor/wood,/area/shuttle/escape)
"dm" = (/obj/structure/extinguisher_cabinet{pixel_x = 28},/obj/machinery/computer/slot_machine,/turf/open/floor/wood,/area/shuttle/escape)
"dn" = (/obj/structure/disposalpipe/segment,/turf/open/floor/plasteel/airless,/area/shuttle/escape)
"do" = (/obj/machinery/vending/cigarette,/turf/open/floor/plasteel/floorgrime,/area/shuttle/escape)
"dp" = (/obj/structure/disposalpipe/trunk,/obj/machinery/disposal/bin,/obj/effect/decal/cleanable/oil,/turf/open/floor/plasteel/floorgrime,/area/shuttle/escape)
"dq" = (/obj/structure/table/wood/bar,/obj/machinery/camera{dir = 4},/turf/open/floor/wood,/area/shuttle/escape)
"dr" = (/obj/structure/table/wood/bar,/turf/open/floor/wood,/area/shuttle/escape)
"ds" = (/obj/structure/table/wood/bar,/obj/structure/sign/nosmoking_1{pixel_x = 28},/turf/open/floor/wood,/area/shuttle/escape)
"dt" = (/obj/machinery/door/airlock/glass{name = "Kitchen"},/turf/open/floor/plasteel/cafeteria,/area/shuttle/escape)
"du" = (/obj/structure/disposalpipe/segment,/obj/structure/sink{dir = 8; pixel_x = -12},/turf/open/floor/plasteel/floorgrime,/area/shuttle/escape)
"dv" = (/obj/structure/extinguisher_cabinet{pixel_y = -30},/obj/effect/decal/cleanable/blood/old,/mob/living/simple_animal/cockroach,/turf/open/floor/plasteel/airless,/area/shuttle/escape)
"dw" = (/obj/structure/mirror{pixel_y = 26},/obj/structure/sign/poster/contraband/rebels_unite{pixel_y = -32},/obj/effect/decal/cleanable/dirt,/obj/effect/decal/cleanable/chem_pile,/turf/open/floor/plating,/area/shuttle/escape)
"dx" = (/obj/structure/urinal{pixel_y = 32},/obj/structure/sign/vacuum{pixel_y = -32},/turf/open/floor/plasteel/floorgrime,/area/shuttle/escape)
"dy" = (/obj/structure/mirror{pixel_y = 26},/obj/item/weapon/surgical_drapes,/obj/structure/sign/poster/contraband/kss13{pixel_x = 32},/obj/item/drone_shell,/turf/open/floor/plasteel/floorgrime,/area/shuttle/escape)
"dz" = (/obj/structure/reagent_dispensers/beerkeg,/obj/effect/decal/cleanable/cobweb,/turf/open/floor/wood,/area/shuttle/escape)
"dA" = (/turf/open/floor/plasteel/cafeteria,/area/shuttle/escape)
"dB" = (/obj/structure/sink/kitchen{pixel_y = 30},/obj/effect/decal/cleanable/flour,/turf/open/floor/plasteel/cafeteria,/area/shuttle/escape)
"dC" = (/obj/structure/disposalpipe/segment,/obj/machinery/door/airlock/maintenance{name = "Cabin 1"},/turf/open/floor/plasteel/showroomfloor,/area/shuttle/escape)
"dD" = (/obj/structure/disposalpipe/segment,/obj/machinery/door/airlock/maintenance{name = "Cabin 2"},/turf/open/floor/plasteel/showroomfloor,/area/shuttle/escape)
"dE" = (/obj/machinery/door/airlock/external,/turf/open/floor/plating,/area/shuttle/escape)
"dF" = (/turf/closed/wall/rust,/area/shuttle/escape)
"dG" = (/obj/machinery/vending/boozeomat,/turf/open/floor/wood,/area/shuttle/escape)
"dH" = (/obj/structure/closet/secure_closet/bar,/turf/open/floor/wood,/area/shuttle/escape)
"dI" = (/obj/machinery/light,/obj/structure/table/wood/bar,/turf/open/floor/wood,/area/shuttle/escape)
"dJ" = (/obj/structure/table/wood/bar,/obj/item/weapon/reagent_containers/food/drinks/shaker,/turf/open/floor/wood,/area/shuttle/escape)
"dK" = (/obj/structure/closet/secure_closet/freezer/cream_pie,/obj/effect/turf_decal/bot,/turf/open/floor/plasteel/cafeteria,/area/shuttle/escape)
"dL" = (/obj/machinery/light/small,/obj/structure/closet/secure_closet/freezer/fridge,/obj/effect/turf_decal/bot,/turf/open/floor/plasteel/cafeteria,/area/shuttle/escape)
"dM" = (/obj/structure/table,/obj/machinery/microwave,/obj/effect/decal/cleanable/dirt,/turf/open/floor/plasteel/cafeteria,/area/shuttle/escape)
"dN" = (/obj/structure/disposalpipe/segment{dir = 1; icon_state = "pipe-c"},/obj/structure/toilet{icon_state = "toilet00"; dir = 8},/obj/machinery/light/small,/obj/item/weapon/wirerod,/obj/effect/decal/cleanable/cobweb,/obj/item/drone_shell,/turf/open/floor/plasteel/showroomfloor,/area/shuttle/escape)
"dO" = (/obj/structure/disposalpipe/junction{dir = 4; icon_state = "pipe-j2"},/obj/structure/toilet{icon_state = "toilet00"; dir = 8},/obj/machinery/light/small,/obj/item/toy/gun,/obj/effect/decal/cleanable/vomit/old,/turf/open/floor/plasteel/showroomfloor,/area/shuttle/escape)
"dP" = (/obj/structure/disposalpipe/segment{dir = 4},/turf/closed/wall/rust,/area/shuttle/escape)
"dQ" = (/obj/structure/disposalpipe/trunk{dir = 8},/obj/structure/disposaloutlet{dir = 4},/obj/effect/decal/cleanable/cobweb,/turf/open/floor/plating,/area/shuttle/escape)
"dR" = (/obj/machinery/light/small,/obj/item/weapon/c_tube,/obj/item/weapon/pneumatic_cannon/ghetto,/turf/open/floor/plating,/area/shuttle/escape)
"dS" = (/obj/structure/lattice,/turf/open/space/basic,/area/shuttle/escape)
"dT" = (/obj/structure/shuttle/engine/heater,/obj/structure/window/reinforced,/turf/open/floor/plating,/area/shuttle/escape)
"dU" = (/obj/structure/shuttle/engine/propulsion,/turf/open/floor/plating,/area/shuttle/escape)

(1,1,1) = {"
aaaaaaaaaaaaabacacacabaaaaaaaaaaaa
ababadaeafababagahaiabacacabababab
abajakalamanabaoapaqabarasatasauab
abavapawapaxabayapazabaAaBaCaBaDab
abaEaFapaGaHabaIapaJaKaLaMaNaNaOab
abaPaQaRaSaTaSaSaSaUaVaWabacacacab
abababababaXabaYaZbabbbcabbdbebfab
abbgbhbibjbkblbmbnbobbapbpbqbrbsab
abbtapbubvapapbwbxbxbbbybzacacacab
abbAbBbCabbDapbEbFbFbGbHbIbJbKbLab
ababbMababbNapbObPbQbbbRapapapapab
bSbTapbUabapapbwbxbxbbapapapapapab
bVbWapapbXapapbYapapbZapcacbapccab
bSabadaeabapapcdapapceapcacbapcfab
cgapapchbncicjckclcmceapcacbapcnab
bSabcoapcpabcqcqcqabcrapcacbapcsab
aaacctapcfcqcucvcwcqceapcacbapcfac
aaacctapcfcqcxcycxczceapcacbapcfac
aaacctapcfcqcAcBcCcqceapcacDapcfac
bSabcEapcpabcqcqcqabcrapcFabababab
bVapapapapcGcHcIcHcJceapcKabcLcMab
accNapapapapapapapcOceapapcPapcQab
bVbWapapapapapapcRaScSabababcTcUab
bSabcVcWcVcWcVcVcVabcXcYcZabdadbab
aaacdcdcdcdcdcdcddabdedfdgabdhdiab
aaacdjdjdjdkdldcdmabdndodpabababab
ababdqdrdsabcVdtababdudvcXdwdxdyab
abdzdcdjdcdtdAdAdBabdCabdDababdEdF
abdGdHdIdJcVdKdLdMabdNaSdOdPdQdRdS
abababababababababababababababdFab
abdTdTdTdTdTdTdTabdTdTdTdTdTdTdTab
aadUdUdUdUdUdUdUabdUdUdUdUdUdUdUaa
"}
